{
	"name": "WellSpring Town",
	"startX": 128,
	"startY": 128,
	"width": 1280,
	"height": 1280,
	"columns": 20,
	"rows": 20,
	"background": [
		[   1,   1,   1,   1,   1,   1,   1,   1,   1,   1,   1,   1,   1,   1,   1,   1,   1,   1,   1,   1],
		[   1,   1,   1,   1,   1,   1,   1,   1,   1,   1,   1,   1,   1,   1,   1,   1,   1,   1,   1,   1],
		[   1,   1,   1,   1,   1,   1,   1,   1,   1,   1,   1,   1,   1,   1,   1,   1,   1,   1,   1,   1],
		[   1,   1,   1,   1,   1,   1,   1,   1,   1,   1,   1,   1,   1,   1,   1,   1,   1,   1,   1,   1],
		[   1,   1,   1,   1,   1,   1,   1,   1,   1,   1,   1,   1,   1,   1,   1,   1,   1,   1,   1,   1],
		[   1,   1,   1,   1,   1,   1,   1,   1,   1,   1,   1,   1,   1,   1,   1,   1,   1,   1,   1,   1],
		[   1,   1,   1,   1,   1,   1,   1,   1,   1,   1,   1,   1,   1,   1,   1,   1,   1,   1,   1,   1],
		[   1,   1,   1,   1,   1,   1,   1,   1,   1,   1,   1,   1,   1,   1,   1,   1,   1,   1,   1,   1],
		[   1,   1,   1,   1,   1,   1,   1,   1,   1,   1,   1,   1,   1,   1,   1,   1,   1,   1,   1,   1],
		[   1,   1,   1,   1,   1,   1,   1,   1,   1,   1,   1,   1,   1,   1,   1,   1,   1,   1,   1,   1],
		[   1,   1,   1,   1,   1,   1,   1,   1,   1,   1,   1,   1,   1,   1,   1,   1,   1,   1,   1,   1],
		[   1,   1,   1,   1,   1,   1,   1,   1,   1,   1,   1,   1,   1,   1,   1,   1,   1,   1,   1,   1],
		[   1,   1,   1,   1,   1,   1,   1,   1,   1,   1,   1,   1,   1,   1,   1,   1,   1,   1,   1,   1],
		[   1,   1,   1,   1,   1,   1,   1,   1,   1,   1,   1,   1,   1,   1,   1,   1,   1,   1,   1,   1],
		[   1,   1,   1,   1,   1,   1,   1,   1,   1,   1,   1,   1,   1,   1,   1,   1,   1,   1,   1,   1],
		[   1,   1,   1,   1,   1,   1,   1,   1,   1,   1,   1,   1,   1,   1,   1,   1,   1,   1,   1,   1],
		[   1,   1,   1,   1,   1,   1,   1,   1,   1,   1,   1,   1,   1,   1,   1,   1,   1,   1,   1,   1],
		[   1,   1,   1,   1,   1,   1,   1,   1,   1,   1,   1,   1,   1,   1,   1,   1,   1,   1,   1,   1],
		[   1,   1,   1,   1,   1,   1,   1,   1,   1,   1,   1,   1,   1,   1,   1,   1,   1,   1,   1,   1],
		[   1,   1,   1,   1,   1,   1,   1,   1,   1,   1,   1,   1,   1,   1,   1,   1,   1,   1,   1,   1]
	],
	"foreground": [
		[ 109, 108, 109, 108, 109, 108, 109, 108, 109, 108, 109, 108, 109, 108, 109, 108, 109, 108, 109, 108],
		[  93, 109,  39,  38,  39,  38,  39,  38,  39,  38,  39,  38,  39,  38,  39,  38,  39,  38,  93,  92],
		[ 109,  39,   0,   0,   0,  74,  75,   0,   0,   0,   0,   0,   0, 244, 229,   0,   0,   0,  38, 108],
		[  93,  23,   0,   0,   0,   0,   0,   0, 121,   0,   0, 121,   0,   0,   0,   0,   0,   0,  22,  92],
		[ 109,  39,   0,   0,   0,   0,   0,   0, 121,   0,   0, 121,   0,   0,   0,   0,   0,   0,  38, 108],
		[  93,  23,   0,   0, 137, 122, 122, 137, 121,   0,   0, 121, 137,   0,   0, 137,   0,   0,  22,  92],
		[ 109,  39,   0,   0, 137, 122, 122, 137, 121,   0,   0, 121, 137,   0,   0, 137,   0,   0,  38, 108],
		[  93,  23,   0,   0,   0,   0,   0,   0, 121,   0,   0, 121,   0,   0,   0,   0,   0,   0,  22,  92],
		[ 109,  39,   0, 121, 121, 121, 121, 121, 121,   0,   0, 121, 121, 121, 121, 121, 121,   0,  38, 108],
		[  93,  23,   0,   0,   0,   0,   0,   0,   0,   0,   0,   0,   0,   0,   0,   0,   0,   0,  22,  92],
		[ 109,  39,   0,   0,   0,   0,   0,   0,   0,   0,   0,   0,   0,   0,   0,   0,   0,   0,  38, 108],
		[  93,  23,   0, 121, 121, 121, 121, 121, 121,   0,   0, 121, 121, 121, 121, 121, 121,   0,  22,  92],
		[ 109,  39,   0,   0,   0,   0,   0,   0, 121,   0,   0, 121,   0,   0,   0,   0,   0,   0,  38, 108],
		[  93,  23,   0,   0, 137, 221, 221, 137, 121,   0,   0, 121, 137, 146, 146, 137,   0,   0,  22,  92],
		[ 109,  39,   0,   0, 137, 221, 221, 137, 121,   0,   0, 121, 137, 146, 146, 137,   0,   0,  38, 108],
		[  93,  23,   0,   0,   0,   0,   0,   0, 121,   0,   0, 121,   0,   0,   0,   0,   0,   0,  22,  92],
		[ 109,  39,   0,   0,   0,   0,   0,   0, 121,   0,   0, 121,   0,   0,   0,   0,   0,   0,  38, 108],
		[  93,  23,   0,   0,   0,   0,   0,   0,   0,   0,   0,   0,   0,   0,   0,   0,   0,   0,  22,  92],
		[ 109, 108,  23,  22,  23,  22,  23,  22,  23,  22,  23,  22,  23,  22,  23,  22,  23,  22,  92, 108],
		[  93,  92,  93,  92,  93,  92,  93,  92,  93,  92,  93,  92,  93,  92,  93,  92,  93,  92,  93,  92]
	],
	"collisions": [
		[   0,   0,   0,   0,   0,   0,   0,   0,   0,   0,   0,   0,   0,   0,   0,   0,   0,   0,   0,   0],
		[   0,   0,   1,   1,   1,   1,   1,   1,   1,   1,   1,   1,   1,   1,   1,   1,   1,   1,   0,   0],
		[   0,   1,   0,   0,   0,   1,   1,   0,   0,   0,   0,   0,   0,   1,   1,   0,   0,   0,   1,   0],
		[   0,   1,   0,   0,   0,   0,   0,   0,   1,   0,   0,   1,   0,   0,   0,   0,   0,   0,   1,   0],
		[   0,   1,   0,   0,   0,   0,   0,   0,   1,   0,   0,   1,   0,   0,   0,   0,   0,   0,   1,   0],
		[   0,   1,   0,   0,   0,   1,   1,   0,   1,   0,   0,   1,   0,   0,   0,   0,   0,   0,   1,   0],
		[   0,   1,   0,   0,   0,   1,   1,   0,   1,   0,   0,   1,   0,   0,   0,   0,   0,   0,   1,   0],
		[   0,   1,   0,   0,   0,   0,   0,   0,   1,   0,   0,   1,   0,   0,   0,   0,   0,   0,   1,   0],
		[   0,   1,   0,   1,   1,   1,   1,   1,   1,   0,   0,   1,   1,   1,   1,   1,   1,   0,   1,   0],
		[   0,   1,   0,   0,   0,   0,   0,   0,   0,   0,   0,   0,   0,   0,   0,   0,   0,   0,   1,   0],
		[   0,   1,   0,   0,   0,   0,   0,   0,   0,   0,   0,   0,   0,   0,   0,   0,   0,   0,   1,   0],
		[   0,   1,   0,   1,   1,   1,   1,   1,   1,   0,   0,   1,   1,   1,   1,   1,   1,   0,   1,   0],
		[   0,   1,   0,   0,   0,   0,   0,   0,   1,   0,   0,   1,   0,   0,   0,   0,   0,   0,   1,   0],
		[   0,   1,   0,   0,   0,   1,   1,   0,   1,   0,   0,   1,   0,   1,   1,   0,   0,   0,   1,   0],
		[   0,   1,   0,   0,   0,   1,   1,   0,   1,   0,   0,   1,   0,   1,   1,   0,   0,   0,   1,   0],
		[   0,   1,   0,   0,   0,   0,   0,   0,   1,   0,   0,   1,   0,   0,   0,   0,   0,   0,   1,   0],
		[   0,   1,   0,   0,   0,   0,   0,   0,   1,   0,   0,   1,   0,   0,   0,   0,   0,   0,   1,   0],
		[   0,   1,   0,   0,   0,   0,   0,   0,   0,   0,   0,   0,   0,   0,   0,   0,   0,   0,   1,   0],
		[   0,   0,   1,   1,   1,   1,   1,   1,   1,   1,   1,   1,   1,   1,   1,   1,   1,   1,   0,   0],
		[   0,   0,   0,   0,   0,   0,   0,   0,   0,   0,   0,   0,   0,   0,   0,   0,   0,   0,   0,   0]
	],
	"npcs": [
		"config/map/WellSpring/instructions/npc/Alicia.json",
		"config/map/WellSpring/instructions/npc/Arthur.json",
		"config/map/WellSpring/instructions/npc/Rapthalia.json",
		"config/map/WellSpring/instructions/npc/Leafa.json",
		"config/map/WellSpring/instructions/npc/Frank.json"
	],
	"signposts": [
		"config/map/WellSpring/instructions/obj/Stone-1.json",
		"config/map/WellSpring/instructions/obj/Stone-2.json",
		"config/map/WellSpring/instructions/obj/Stone-3.json",
		"config/map/WellSpring/instructions/obj/Stone-4.json",
		"config/map/WellSpring/instructions/obj/Barrel.json"
	],
	"sprites": [
		{
			"name": "props",
			"path": "gfx/tile/props.png",
			"multiSprite": true,
			"width": 64,
			"height": 64
		},
		{
			"name": "grass",
			"path": "gfx/tile/grass.png",
			"multiSprite": false,
			"width": 0,
			"height": 0
		},
		{
			"name": "stone",
			"path": "gfx/tile/stone.png",
			"multiSprite": false,
			"width": 0,
			"height": 0
		},
		{
			"name": "barrel",
			"path": "gfx/tile/barrel.png",
			"multiSprite": false,
			"width": 0,
			"height": 0
		},


		
		{
			"name": "princess",
			"path": "gfx/char/princess.png",
			"multiSprite": false,
			"width": 0,
			"height": 0
		},
		{
			"name": "sawyer",
			"path": "gfx/char/sawyer.png",
			"multiSprite": false,
			"width": 0,
			"height": 0
		},
		{
			"name": "demi",
			"path": "gfx/char/demi.png",
			"multiSprite": false,
			"width": 0,
			"height": 0
		},
		{
			"name": "fairy",
			"path": "gfx/char/fairy.png",
			"multiSprite": false,
			"width": 0,
			"height": 0
		},
		{
			"name": "monk",
			"path": "gfx/char/monk.png",
			"multiSprite": true,
			"width": 64,
			"height": 64
		}
	]
}